4 4 4 4 4 4 4 4 4 4 4 4 4 4 4 4 4 4 4 4 4 4 4 4 4 4 4 4 4 4 4 4 4 4 4 4 4 4 4 4 4 4 4 4 4 4 4 4 4 4 4 4 4 4 4
4 4 4 4 4 4 4 4 4 4 4 4 4 4 4 4 4 4 4 4 4 4 4 4 4 4 4 4 4 4 4 4 4 4 4 4 4 4 4 4 4 4 4 4 4 4 4 4 4 4 4 4 4 4 4
4 4 4 4 4 4 4 4 4 4 4 4 4 4 4 4 4 4 4 4 4 4 4 4 4 4 4 4 4 4 4 4 4 4 4 4 4 4 4 4 4 4 4 4 4 4 4 4 4 4 4 4 4 4 4
4 4 4 4 4 4 4 4 4 4 4 4 4 4 4 4 4 4 16 2 2 2 2 17 4 4 4 4 4 4 4 4 4 4 4 4 4 4 4 4 4 4 4 4 4 4 4 4 4 4 4 4 4 4
4 0 0 0 0 0 0 0 0 0 0 0 0 0 0 0 0 4 4 16 2 2 2 17 0 0 0 0 0 0 0 0 0 0 0 0 1 1 1 1 1 1 1 0 0 0 0 0 0 4 4 4 4 4
4 0 0 0 0 0 0 0 0 3 3 3 0 0 0 0 0 5 4 16 2 2 2 17 0 0 0 0 0 0 0 0 0 0 0 0 1 0 0 0 0 0 1 0 0 0 0 0 0 4 4 4 4 4
4 0 0 0 0 0 0 0 0 0 0 3 3 3 3 3 3 0 4 16 2 2 2 17 4 4 4 4 4 4 4 4 0 0 0 0 1 0 0 0 0 0 1 0 0 0 0 0 0 4 4 4 4 4
4 0 0 4 4 4 4 4 4 4 4 4 0 0 0 0 3 0 4 16 2 2 2 21 14 14 14 14 14 14 14 15 4 4 0 0 1 1 1 0 1 1 1 0 0 4 4 4 0 4 4 4 4 4
4 4 3 4 4 4 4 4 4 4 4 4 4 0 0 0 3 0 4 18 19 19 19 19 19 19 19 19 19 19 19 20 4 4 4 0 0 0 0 0 0 0 0 0 4 4 4 0 0 4 4 4 4 4
4 4 3 4 4 4 4 4 4 4 4 4 4 4 0 0 3 0 0 0 0 4 4 4 4 4 4 4 0 0 0 0 0 4 4 4 4 4 4 0 4 4 4 4 4 4 4 4 4 4 4 4 4 4
4 4 3 4 4 4 4 3 4 4 4 4 4 4 0 0 3 0 0 0 0 0 0 0 0 0 0 4 0 0 0 0 0 0 0 0 0 0 0 0 0 0 0 0 0 0 0 0 0 4 4 4 4 4
4 4 3 3 3 3 3 3 4 4 4 4 4 4 0 0 3 0 0 0 0 0 0 0 0 0 0 4 0 0 0 4 0 0 0 0 0 0 0 3 0 0 0 0 0 0 0 0 0 4 4 4 4 4
4 4 4 4 4 4 4 4 4 4 4 4 4 0 0 0 3 0 0 0 0 0 0 0 0 0 0 4 0 0 0 4 0 0 0 0 0 0 0 3 0 0 0 0 0 0 0 0 0 4 4 4 4 4
4 4 4 4 4 4 4 4 4 4 0 0 0 0 4 0 3 0 0 0 0 0 0 0 0 0 0 4 0 0 0 4 0 5 5 0 4 4 4 3 0 0 0 0 0 0 0 0 0 4 4 4 4 4
4 4 4 4 4 4 4 4 0 0 0 0 0 0 0 0 3 0 0 0 0 0 0 4 4 4 4 4 0 0 0 0 0 5 5 0 0 0 0 3 0 0 0 0 0 0 0 0 4 4 4 4 4 4
4 0 4 0 0 0 0 0 0 0 0 0 0 0 0 0 3 0 0 0 0 0 0 4 5 5 5 4 0 0 0 0 0 0 0 0 4 0 4 3 0 0 0 0 0 0 13 14 14 14 4 4 4 4
4 0 0 0 0 0 0 0 0 0 0 0 0 0 0 0 3 0 0 0 0 0 0 4 5 5 5 4 0 0 0 0 0 0 0 0 0 0 4 3 0 0 0 0 0 0 16 2 2 2 4 4 4 4
4 0 0 4 0 0 0 0 0 0 0 0 0 0 0 0 3 0 0 0 0 0 0 4 5 5 5 4 0 0 0 0 0 0 0 0 0 0 0 3 3 3 3 0 0 0 16 2 2 2 4 4 4 4
4 4 0 0 0 0 0 0 0 0 0 0 0 0 0 0 3 0 0 0 0 0 0 4 4 0 4 4 4 4 4 4 4 4 4 4 4 4 4 3 0 0 3 3 3 0 16 2 2 2 4 4 4 4
4 4 4 0 0 0 3 3 3 3 3 3 3 3 3 3 3 0 0 0 0 0 0 0 0 3 0 0 0 0 0 0 0 0 0 0 0 0 0 3 0 0 0 0 3 0 16 2 2 2 4 4 4 4
4 4 0 0 0 0 0 0 0 0 0 0 0 0 0 0 3 0 0 0 0 0 0 0 0 3 3 3 3 3 3 3 3 3 3 3 3 3 3 3 0 0 0 0 3 0 16 2 2 2 4 4 4 4
4 0 0 0 0 0 0 0 0 0 0 0 0 6 0 0 3 0 0 0 0 0 0 0 0 3 0 0 0 0 0 3 0 0 0 0 0 0 0 0 0 0 0 0 3 0 16 2 2 2 4 4 4 4
4 0 4 0 0 0 0 0 0 0 0 0 0 0 0 0 3 3 3 3 3 3 3 3 3 3 0 0 0 0 0 3 0 0 0 0 0 0 0 0 0 0 0 0 3 0 18 19 19 19 4 4 4 4
4 4 4 0 0 0 0 0 0 6 0 0 0 0 0 0 0 0 0 0 0 0 0 0 0 0 0 0 0 0 0 3 0 0 0 0 0 0 0 0 0 0 0 0 3 0 0 0 0 4 4 4 4 4
4 0 0 0 0 0 0 0 0 0 0 0 0 0 0 0 0 0 0 0 4 4 4 4 4 0 0 0 0 0 0 3 0 0 0 0 0 0 0 0 0 0 0 0 3 0 0 0 0 4 4 4 4 4
4 4 4 4 0 0 0 0 0 0 0 0 0 0 0 0 0 4 4 4 4 4 4 4 4 4 4 0 0 0 0 3 0 0 0 0 0 0 0 0 0 0 0 0 3 0 0 0 0 4 4 4 4 4
4 0 0 0 4 6 0 0 0 0 0 0 0 0 0 0 0 4 4 4 4 4 0 0 0 0 0 0 0 0 0 3 0 0 0 0 0 0 0 0 0 0 0 0 3 0 0 0 0 4 4 4 4 4
4 0 0 0 0 0 0 0 0 0 0 0 0 0 0 0 0 4 4 4 4 4 0 0 0 0 0 0 0 0 0 3 0 0 0 0 0 0 0 0 0 0 0 0 3 3 3 3 3 4 4 4 4 4
4 4 4 4 4 4 4 4 4 4 4 4 0 0 0 0 0 4 4 4 4 4 0 0 0 0 0 0 0 0 0 3 0 0 0 0 0 0 0 0 0 0 0 0 3 0 0 0 3 4 4 4 4 4
4 4 4 4 4 4 4 4 4 4 0 0 0 0 0 0 0 4 4 4 4 4 0 0 0 0 0 0 0 0 0 3 0 0 0 0 0 0 0 0 0 0 0 0 3 0 4 0 3 4 4 4 4 4
4 4 4 4 4 4 4 4 0 0 0 0 0 0 0 0 0 4 4 4 4 4 4 0 4 4 0 0 0 0 0 3 3 3 3 3 3 3 3 3 3 3 3 3 3 4 4 4 3 4 4 4 4 4
4 4 4 4 4 4 4 0 0 6 0 0 0 0 0 0 0 4 4 4 4 4 4 4 4 4 4 0 0 0 0 0 0 0 0 0 0 0 0 0 0 0 0 0 0 4 4 4 3 4 4 4 4 4
4 4 4 4 4 4 0 0 0 0 0 0 0 6 0 0 0 4 0 0 0 4 0 0 0 4 0 4 4 4 0 4 0 4 4 4 4 0 4 4 4 4 4 4 4 4 4 4 0 4 4 4 4 4
4 4 4 0 0 0 4 4 4 4 4 4 4 4 4 4 4 4 0 4 0 4 4 0 4 0 0 0 4 0 0 4 0 4 0 0 0 0 0 0 0 0 0 0 0 0 0 0 0 4 4 4 4 4
4 4 0 0 4 0 0 0 0 0 0 0 0 4 6 0 0 0 0 4 4 0 0 0 0 0 0 0 4 0 4 0 4 0 0 4 4 0 4 0 0 4 0 0 0 0 0 0 0 4 4 4 4 4
4 4 0 4 4 4 4 4 4 4 4 4 0 4 0 4 0 4 0 4 4 4 4 4 4 4 4 0 4 0 0 0 0 0 4 0 4 0 0 0 0 4 0 0 0 0 0 0 0 4 4 4 4 4
4 4 0 0 4 4 4 4 4 4 0 4 0 4 0 0 0 4 4 4 0 0 4 0 0 0 0 0 0 4 4 0 0 0 0 0 4 4 0 0 0 4 0 0 0 0 0 0 0 4 4 4 4 4
4 4 4 0 0 0 0 0 0 0 0 0 0 0 4 0 6 4 0 0 0 4 0 0 4 0 0 4 0 0 4 4 4 0 4 0 0 4 0 4 0 0 0 0 0 0 0 0 0 4 4 4 4 4
4 4 4 6 0 0 0 0 0 0 6 4 0 4 0 0 0 4 0 4 0 0 0 0 4 0 4 4 0 0 0 4 0 0 0 4 0 4 0 4 0 4 0 0 0 0 0 0 0 4 4 4 4 4
4 4 0 0 0 0 0 0 0 0 0 0 0 4 0 4 0 0 0 4 4 0 4 0 4 4 0 4 4 4 0 4 0 4 0 0 0 4 4 4 0 0 4 0 0 0 0 0 0 4 4 4 4 4
4 4 0 0 4 4 0 0 0 0 0 4 0 4 0 0 4 4 0 4 0 0 0 4 0 0 0 0 0 4 0 0 0 4 0 4 4 0 0 0 4 0 4 0 0 0 0 0 0 4 4 4 4 4
4 4 4 4 4 4 4 0 0 0 0 0 0 0 0 4 4 4 0 4 0 0 4 0 0 4 4 4 0 4 0 4 4 0 0 0 0 0 4 0 0 0 0 4 0 0 0 0 0 4 4 4 4 4
4 4 0 0 0 0 0 0 0 0 0 4 0 4 0 0 0 4 0 0 0 0 4 0 4 4 0 0 0 0 0 0 4 0 0 4 0 0 0 0 4 4 0 4 0 0 0 0 0 4 4 4 4 4
4 4 4 4 4 4 4 4 4 4 4 4 4 4 4 4 4 4 4 4 4 4 4 4 4 4 4 4 4 4 4 4 4 4 4 4 4 4 4 4 4 4 4 4 4 4 4 4 4 4 4 4 4 4
4 4 4 4 4 4 4 4 4 4 4 4 4 4 4 4 4 4 4 4 4 4 4 4 4 4 4 4 4 4 4 4 4 4 4 4 4 4 4 4 4 4 4 4 4 4 4 4 4 4 4 4 4 4
4 4 4 4 4 4 4 4 4 4 4 4 4 4 4 4 4 4 4 4 4 4 4 4 4 4 4 4 4 4 4 4 4 4 4 4 4 4 4 4 4 4 4 4 4 4 4 4 4 4 4 4 4 4
4 4 4 4 4 4 4 4 4 4 4 4 4 4 4 4 4 4 4 4 4 4 4 4 4 4 4 4 4 4 4 4 4 4 4 4 4 4 4 4 4 4 4 4 4 4 4 4 4 4 4 4 4 4
4 4 4 4 4 4 4 4 4 4 4 4 4 4 4 4 4 4 4 4 4 4 4 4 4 4 4 4 4 4 4 4 4 4 4 4 4 4 4 4 4 4 4 4 4 4 4 4 4 4 4 4 4 4